## Jupyter Notebook

# 단축키 (Shortcut) : Edit Mode 단축키
  

Tab : 코드 자돈완성 들여쓰기
Shift-Tab : 툴팁
Ctrl-[ : 들여쓰기 
Ctrl-] : 내어쓰기
Ctrl-a : 전체 선택
Ctrl-z : undo 
Ctrl-Shift-z : redo
Ctrl-Home : 셀 처음으로 이동
Ctrl-End : 셀 끝으로 이동
Ctrl-Left : 한 단어 좌측 이동
Ctrl-Right : 한 단어 우측 이동
Ctrl-Backspace : 이전 단어 삭제
Ctrl-Delete : 이후 단어 삭제
Esc : command mode
Ctrl-m : command mode
Shift-Enter : run cell
Ctrl-Enter : run cell
Alt-Enter : run cell, 다음 셀 삽입
Ctrl-Shift- 셀 분할
Ctrl-s 노트북 파일 열기

# Command Mode 단축기

Enter : Edit mode 진입
Shift-Enter : run cell, 다음 셀 선택
Ctrl-Enter :  run cell
Alt-Enter : run cell, 다음 셀 삽입
y : Code 셀로 변환
m : Markdown 셀로 변환 
r : Raw NB 셀로 변환
a : 위에 셀 삽입
b : 아래 셀 삽입
k/ 방향키 위 : 이전 셀로 이동
c : 셀 복사
Shift-v : 위에 붙여넣기
v : 아래 붙여넣기
x : 셀 잘래내기
dd : 셀 삭제
z : undo 이전 삭제 복구
Shift-m : 아래 셀과 병합
s : 노트북 저장
Ctrl-s : 노트북 저장
l : 해당 셀의 라인번호 토글
o : 결과값 토글
Shift-o : 결과값 토글
h : keyboard shortcuts
ii : interrupt kernel
oo : restart kernel
j/방향키 아래 : 다음 셀로 이동



